** ********* **** **** **** **** ********* *******
** ********* **** **** **** **** ********* *******
  S     **   **   **             **               
** **** ********* ********* **** **** **** **** **
** **** ********* ********* **** **** **** **** **
** **** ********* ********* **** **** **** *******
** **** ********* ********* **** **** **** *******
**           **        **   **   ****      ****   
******* **** ********* **** **** ************** **
******* **** ********* **** **** ************** **
************ **** **** ********* **** **** *******
************ **** **** ********* **** **** *******
   **     **           **        **               
** **** **** **** ********* ********* ********* **
** **** **** **** ********* ********* ********* **
** **** **** ********* **** ********* ********* **
** **** **** ********* **** ********* ********* **
**        **   **   **      **                  **
** ********* **** **** ********* ********* *******
** ********* **** **** ********* ********* *******
***************** **** ******************* *******
***************** **** ******************* *******
**      **        ****           **        ****   
** **** **** **** **** **** **** **** **** **** **
** **** **** **** **** **** **** **** **** **** **
******* **** **** ********* **** **** **** *******
******* **** **** ********* **** **** **** *******
               **        **           ****   **   
** ************** **** **** ********* **** **** **
** ************** **** **** ********* **** **** **
** ********* ********* **** **** ************** **
** ********* ********* **** **** ************** **
**      ****           **                  **     
** **** **** **** **** ********* **** **** **** **
** **** **** **** **** ********* **** **** **** **
***************** ********* **** ********* *******
***************** ********* **** ********* *******
   **     **      ****                ****      **
** **** **** ********* **** ********* ********* **
** **** **** ********* **** ********* ********* **
************ ********* ********* **** **** *******
************ ********* ********* **** **** *******
**           ****   **           ****             
** **** **** **** ********* **** ************** **
** **** **** **** ********* **** ************** **
** ********* **** **** **** **** **** **** **** **
** ********* **** **** **** **** **** **** **** **
**   **                **   ****   **           **
******* ***************************** **** **** **
******* ***************************** **** ****E**